1111111111111111111
1000010000000000001
1001011111111111101
1111010000000000001
1000000111110111101
1201111111110100101
1000000000010100101
1101011101111101101
1101000100100000001
1101011100111111101
1100011000100010001
1001011010101010101
1011001010101010101
1001100010101111101
1001101110100000001
1000000000101111101
1101111110111000101
1101111111100010101
1101010100101110101
1101000110101000101
1101010000101111101
1101011111100000001
1001000000001111101
1101111111111111101
1001000100000001101
1301010111111101101
1000010000000000001
1111111111111111111
